*****************
  D   [L    ] 

*****  *******
      [ L      ]
   ******  

*****
[   L          ]
*******
 P       L    
****************
