****************
      L

   *****  *****
     P         L
******  ***
      [L     ]
*     ***** ****

*******     D
[     L]
****************
