****************
      L         
            
     **** *****
     P         
******  ***      
       L       
*     ***** ****
              
*******     
[     L]    D   
****************
