****************

  [      L]
  D********** L
         L
*****   ***  *
          [L  ]
*    *******
  L
*******    ****
[      P      ]
****************
