    L        
   ********  ***
   [   ]   *  
  ****** ** *    
L        L   
****** ********
  
*******     
  	
    *** D
[  L ]      P
****************
